######################################################################################################################################################
#                                                                                                                                                    #
#                                                                                                                                                    #
#                                                                                                                                                    #
#                                                                                                                                                    #
#                                                                                                                                                    #
#                                                                                                                                                    #
#                                                                                                                                                    #
#                                                                                                                                                    #
#                                                                                                                                                    #
#                                                                                                                                                    #
#                                                                                                                                                    #
#                                                                                                                                                    #
#                                                                                                                                                    #
#                                                                                                                                                    #
#                                                                                      #####                                                         #
#                                                                                #####                                                               #
#                                                                          #####                                                                     #
#                                               #####                #####                                                                           #
#                                     X   #####                #####                                                                                 #
#                   ######    ##    #####                #####                                                                                       #
#                                                                                                                                                    #
#             ###                                                                                                                                    #
#      P                                                                                                                                             #
#   #######                                                                                                                                          #
#                        E                                                                                                                           #
######################################################################################################################################################